00000000000000000000
0000000P000000000000
0000000W000000000000
0000000WW00000000000
0000000WWW0000000000
00000000000000000000
000000000WWWW0000000
00000000WWWWWW000000
0000000WWWWWWWW00000
000000WWWWWWWWWW0000
00000000000000000000